----------------------------------|
-                                -|
-                                -|
----            !         --     --|
-            --                  -|
-      !                          -|
-                                -|
-                                -|
--                   ----        -|
-                                -|
--        !                       -|
-                                -|
-           *                --- -|
-               !                 -|
-                                -|
-      ---         !              -|
-                                -|
-   --------   *     ----        -|
-                                -|
-        *         !        -      -|
-                            --  -|
-    p             *               -|
-       !                         -|
---------------              --  -|
-                                -|
-                     !           -|
----------------------------------|